
NO bluestone.xpm
SO bluestone.xpm
EA wood.xpm
WE wood.xpm

F 164,169,20
C 153,204,255

1111111111
1000S00001
100000001
100000001
100000001
111111111

