
NO textures/north.xpm
SO textures/south.xpm
EA textures/east.xpm
WE textures/west.xpm


F 164,169,20
C 153,204,255


111111111
100000001
100000001
100000001
100000001
1000S0001
100000001
100000001
100000001
100000001
100000001
100100001
100000001
111111111
