NO ./wolftex/greystone.xpm
SO ./wolftex/greystone.xpm
WE ./wolftex/greystone.xpm
EA ./wolftex/greystone.xpm

F 220,100,0
C 225,30,0

1111111111111111111111
1000000000000000000001
1000000000100000000001
1000000000000000000001
1000001000N00010000001
1000000000000000000001
1000000000100000000001
1000000000000000000001
1000000000000000000001
1000000000000000000001
1111111111111111111111
